1111111111111111111111111111
1P00000C00000000C00000000001
100CC01110000C0000000000C001
11111111110000000000C0000C01
1111111111100000000000000001
1000001111111110101010100001
10CC000111111101010101010C01
10CC000011111010101010100001
10000000011100C000000000C001
100C000000100000000C00E00C01
1000000000C00000000000000001
1111111111111111111111111111