111111111111111111111111
1P111000000000C000000001
1011C0000000000000000001
110111111111100000000001
10001111111100000000E001
100000000000000C00000001
100000000000000000000001
111111111111111111111111