11111111111111111
1P111000000000001
1011000CCCCC00001
10011110X00X00001
10C0111000XXX0E01
10C00000000X00001
10C00X00000C00001
11111111111111111