11111111111111111
1P111000C000C0001
1011C000000000C01
1C01111C000C00001
10001110000000E01
100C00000C0000001
1C00000000000C001
11111111111111111