11111111111
1P111000001
1011C000C01
1C00000C001
10000000E01
11111111111